contented:	contenpted -> ['cons', 'consented', 'content', 'conten', 'contented']	contende -> ['contend', 'contented', 'continue', 'contents', 'contend']	contended -> ['contend', 'content', 'intended', 'content', 'contented']	contentid -> ['contents', 'contend', 'contente', 'contente', 'contented']
beginning:	begining -> ['beginni', 'beginn', 'beginnin', 'beginn', 'beginning']
problem:	problam -> ['proble', 'proble', 'proclaim', 'problems', 'problem']	proble -> ['noble', 'robe', 'probe', 'problem', 'probe']	promblem -> ['p', 'problems', 'prob', 'pro', 'problem']	proplen -> ['proper', 'problem', 'proven', 'people', 'prophet']
driven:	dirven -> ['darken', 'diver', 'driven', 'given', 'dirge']
ecstasy:	exstacy -> ['eu', 'eu', 'ec', 'ecstasy', 'eustace']	ecstacy -> ['e', 'ecstas', 'ecstas', 'eustace', 'ecstasy']
juice:	guic -> ['quit', 'gulp', 'm', 'mic', 'guv']	juce -> ['jun', 'rude', 'jack', 'juice', 'june']	jucie -> ['juic', 'juic', 'judge', 'laci', 'juice']	juise -> ['just', 'g', 'g', 'juic', 'guise']	juse -> ['ouse', 'use', 'fuse', 'jose', 'just']
locally:	localy -> ['lonely', 'local', 'locall', 'locally', 'local']
compare:	compair -> ['complain', 'compare', 'compass', 'compare', 'company']
pronunciation:	pronounciation -> ['profana', 'provoca', 'c', 'conjunc', 'provocation']
transportability:	transportibility -> ['re', 'r', 'r', 're', 'responsibility']
minuscule:	miniscule -> ['miniatur', 'minute', 'miniat', 'ridicule', 'miniature']
independent:	independant -> ['i', 'independe', 'dependant', 'independe', 'independent']	independant -> ['i', 'independe', 'dependant', 'independe', 'independent']
arranged:	aranged -> ['r', 'ar', 'arr', 'arranged', 'ranged']	arrainged -> ['ar', 'arra', 'arrange', 'arran', 'arranged']
poetry:	poartry -> ['portray', 'portly', 'partl', 'poult', 'paltry']	poertry -> ['portly', 'poultr', 'poet', 'poe', 'poetry']	poetre -> ['poets', 'm', 'metre', 'poets', 'poetry']	poety -> ['poet', 'poetr', 'poets', 'piet', 'poesy']	powetry -> ['powdery', 'poultr', 'poe', 'po', 'poetry']
level:	leval -> ['real', 'heal', 'peal', 'level', 'legal']
basically:	basicaly -> ['scaly', 'rascal', 'sickly', 'musica', 'radical']
triangular:	triangulaur -> ['tri', 'trian', 'triangular', 'triangula', 'triangular']
unexpected:	unexpcted -> ['unexpe', 'unexpected', 'unexpec', 'unexpe', 'unexpected']	unexpeted -> ['unexpected', 'unexpe', 'unexpect', 'unexpec', 'unexpected']	unexspected -> ['uns', 'unsuspected', 'unexp', 'unex', 'unexpected']
standardizing:	stanerdizing -> ['stand', 'stand', 'stand', 'standi', 'standing']
variable:	varable -> ['beara', 'varia', 'capab', 'eatab', 'variable']
further:	futher -> ['gather', 'author', 'hither', 'further', 'father']
monitoring:	monitering -> ['mi', 'l', 'lo', 'ministeri', 'loitering']
biscuits:	biscits -> ['visits', 'biscuit', 'biscui', 'biscu', 'biscuits']	biscutes -> ['d', 'd', 'biscuit', 'dispute', 'biscuits']	biscuts -> ['discuss', 'biscuit', 'biscuit', 'biscui', 'biscuits']	bisquits -> ['bisc', 'biscuit', 'bisc', 'bisc', 'biscuits']	buiscits -> ['biscui', 'pursuit', 'b', 'biscu', 'biscuits']	buiscuts -> ['biscuit', 'biscui', 'bi', 'b', 'biscuits']
available:	avaible -> ['avai', 'available', 'availed', 'avail', 'audible']
separate:	seperate -> ['desperate', 'temperate', 'o', 'operate', 'separate']
necessary:	neccesary -> ['nec', 'necess', 'nec', 'neces', 'necessary']	necesary -> ['n', 'necessa', 'neces', 'necess', 'necessary']	neccesary -> ['nec', 'necess', 'nec', 'neces', 'necessary']	necassary -> ['nec', 'ne', 'nece', 'nece', 'necessary']	necassery -> ['necessity', 'necessa', 'nece', 'nece', 'necessary']	neccasary -> ['neces', 'nec', 'nece', 'nece', 'necessary']
definition:	defenition -> ['decep', 'detonatio', 'deceptio', 'depositi', 'repetition']
receipt:	receit -> ['repent', 'regent', 'receipt', 'recent', 'deceit']	receite -> ['deceive', 'receipt', 'receipts', 'recipe', 'receive']	reciet -> ['resist', 'regret', 'recipe', 'relief', 'recipe']	recipt -> ['resist', 'recei', 'rece', 'receipt', 'recipe']
remind:	remine -> ['retire', 'remind', 'rein', 'refine', 'remind']	remined -> ['remind', 'refined', 'remaine', 'reminde', 'reined']
initials:	inetials -> ['initia', 'initi', 'ini', 'ini', 'initials']	inistals -> ['init', 'initi', 'initi', 'initi', 'initials']	initails -> ['entrail', 'initi', 'initia', 'initia', 'initials']	initals -> ['inroad', 'animals', 'initia', 'initi', 'initials']	intials -> ['intents', 'indians', 'init', 'ini', 'initials']
magnificent:	magnificnet -> ['magnifice', 'magnific', 'magnificen', 'magnificen', 'magnificent']	magificent -> ['mag', 'munifice', 'magni', 'magn', 'magnificent']	magnifcent -> ['ma', 'ma', 'magnific', 'magnifi', 'magnificent']	magnifecent -> ['magnifice', 'magnific', 'magnifi', 'magnifi', 'magnificent']	magnifiscant -> ['magnifice', 'magnifi', 'magnifice', 'magnific', 'magnificent']	magnifisent -> ['ma', 'ma', 'magnific', 'magnific', 'magnificent']	magnificant -> ['s', 'significant', 'magnifice', 'magnifice', 'magnificent']
aunt:	annt -> ['ann', 'aunt', 'anna', 'an', 'ant']	anut -> ['ab', 'n', 'ant', 'abut', 'nut']	arnt -> ['au', 'arat', 'aunt', 'ant', 'art']
initial:	intial -> ['u', 'india', 'until', 'initials', 'indian']
there:	ther -> ['them', 'other', 'the', 'ether', 'their']
experiences:	experances -> ['experi', 'experien', 'experi', 'experie', 'experiences']
built:	biult -> ['fault', 'be', 'belt', 'bill', 'bill']
totally:	totaly -> ['notar', 'total', 'totall', 'totally', 'totals']
understand:	undersand -> ['undertone', 'und', 'understa', 'underst', 'understand']	undistand -> ['under', 'distant', 'unders', 'under', 'understand']
southern:	southen -> ['southern', 'souther', 'soften', 'southend', 'southern']
definitely:	definately -> ['d', 'defini', 'defini', 'delicat', 'definitely']	difinately -> ['defini', 'delicat', 'de', 'de', 'definitely']
visited:	fisited -> ['fished', 'limite', 'v', 'v', 'visited']	viseted -> ['rivete', 'viewe', 'visi', 'visi', 'visited']	vistid -> ['visit', 'viv', 'vivid', 'distil', 'victim']	vistied -> ['visit', 'visit', 'pitied', 'visite', 'vested']
voluntary:	volantry -> ['ga', 'gallantr', 'violent', 'valiant', 'vacantly']
meant:	ment -> ['melt', 'lent', 'men', 'met', 'pent']
receive:	recieve -> ['recede', 'believe', 'recip', 'recipe', 'relieve']
sources:	sorces -> ['sou', 'sor', 'sores', 'sources', 'forces']
whether:	wether -> ['wh', 'whether', 'weather', 'ether', 'nether']
useful:	usefull -> ['usefully', 'usefu', 'useful', 'usefully', 'useful']
literature:	litriture -> ['litera', 'liter', 'litera', 'liter', 'literature']
valuable:	valubale -> ['valua', 'valuabl', 'valuab', 'valuab', 'valuable']	valuble -> ['valuab', 'valua', 'bauble', 'value', 'valuable']
desiccate:	desicate -> ['devia', 'ded', 'ded', 'delicate', 'dedicate']	dessicate -> ['dissipate', 'del', 'delicate', 'ded', 'dedicate']	dessiccate -> ['del', 'delicate', 'dese', 'des', 'desecrate']
clerical:	clearical -> ['chem', 'clearin', 'clearin', 'chemical', 'clearing']
splendid:	spledid -> ['spl', 's', 'splend', 'splen', 'splendid']	splended -> ['splendi', 'pleaded', 'slender', 'splendi', 'splendid']	splened -> ['splendi', 'splendid', 'speed', 'slewed', 'spend']	splended -> ['splendi', 'pleaded', 'slender', 'splendi', 'splendid']
between:	beetween -> ['b', 'bet', 'b', 'be', 'between']
completely:	completly -> ['complete', 'completel', 'completed', 'complete', 'completely']
account:	acount -> ['ac', 'count', 'acc', 'account', 'amount']
cemetery:	cemetary -> ['c', 'ceme', 'cemete', 'cemete', 'cemetery']	semetary -> ['c', 'secr', 'secretary', 'sedenta', 'cemetery']
special:	speaical -> ['spec', 'pelican', 'specia', 'spec', 'special']	specail -> ['specie', 'specia', 'specia', 'special', 'specie']	specal -> ['peal', 'specks', 'specia', 'speci', 'special']	speical -> ['o', 'speci', 'speci', 'special', 'optical']
latest:	lates -> ['late', 'hates', 'gates', 'later', 'latest']	latets -> ['las', 'lasts', 'late', 'hates', 'gates']	latiest -> ['lofties', 'latent', 'late', 'lat', 'latest']	latist -> ['lar', 'latent', 'lars', 'late', 'latest']
perhaps:	perhapse -> ['phase', 'purchase', 'perhaps', 'perhaps', 'perhaps']
remember:	rember -> ['timber', 'robber', 'temper', 'member', 'ember']	remeber -> ['remoter', 'rememb', 'member', 'ember', 'remember']	rememmer -> ['re', 'remem', 'rememb', 'rememb', 'remember']	rermember -> ['r', 're', 'rem', 're', 'remember']
chapter:	chaper -> ['paper', 'shaped', 'chapel', 'chapter', 'cheaper']	chaphter -> ['chapt', 'char', 'charter', 'chap', 'chapter']	chaptur -> ['chapte', 'capto', 'charter', 'capture', 'chapter']
cake:	cak -> ['cat', 'cap', 'oak', 'can', 'ak']
various:	vairious -> ['v', 'vicious', 'var', 'va', 'various']
february:	febuary -> ['janu', 'feb', 'febru', 'febr', 'february']
pretend:	pertend -> ['pre', 'pre', 'petted', 'extend', 'pretend']	protend -> ['pre', 'proved', 'probed', 'pre', 'pretend']	prtend -> ['ostend', 'pru', 'prund', 'extend', 'pretend']	pritend -> ['printed', 'prided', 'pre', 'pre', 'pretend']
choosing:	chosing -> ['closi', 'choo', 'choosi', 'chasi', 'choking']
wrote:	rote -> ['rate', 'rome', 'rope', 'robe', 'rose']	wote -> ['wot', 'woe', 'wrote', 'note', 'vote']
particular:	particulaur -> ['particular', 'particulari', 'particulars', 'particula', 'particular']
awful:	awfall -> ['wall', 'awfully', 'awful', 'awful', 'fall']	afful -> ['aw', 'aw', 'foul', 'lawf', 'awful']
arrangement:	arragment -> ['arrangem', 'armam', 'fr', 'f', 'fragment']
challenges:	chalenges -> ['chan', 'chan', 'chall', 'challenge', 'changes']	chalenges -> ['chan', 'chan', 'chall', 'challenge', 'changes']
laugh:	lagh -> ['ash', 'leash', 'laugh', 'lash', 'lag']	lauf -> ['last', 'lame', 'lard', 'lamb', 'lag']	laught -> ['t', 'augh', 'laugh', 'caug', 'taught']	lugh -> ['u', 'hugh', 'ugh', 'lush', 'laugh']
often:	ofen -> ['omen', 'ofte', 'oxen', 'open', 'oven']	offen -> ['oft', 'oft', 'offend', 'offer', 'often']	offten -> ['oft', 'offend', 'o', 'of', 'often']	ofton -> ['orgo', 'ofte', 'cotto', 'norto', 'often']
someone:	somone -> ['boone', 'smote', 'domine', 'simon', 'someone']
personnel:	personnell -> ['personal', 'persona', 'person', 'personally', 'personally']
unique:	uneque -> ['untru', 'undue', 'uni', 'uni', 'unique']
diagrammatically:	diagrammaticaally -> ['g', 'grammatica', 'grammatical', 'grammatica', 'grammatical']
description:	discription -> ['de', 'discre', 'discretion', 'de', 'description']
poems:	poims -> ['prima', 'pomp', 'toils', 'poe', 'poems']	pomes -> ['pores', 'poles', 'comes', 'homes', 'poses']
purple:	perple -> ['peo', 'pebb', 'pu', 'people', 'purple']	perpul -> ['percy', 'peri', 'peril', 'peru', 'perdu']	poarple -> ['portly', 'pale', 'parade', 'pu', 'purple']
decide:	descide -> ['describe', 'desire', 'despise', 'beside', 'decide']
articles:	articals -> ['arriv', 'article', 'article', 'arrival', 'articles']
position:	possition -> ['positions', 'posi', 'po', 'pos', 'position']
extended:	extented -> ['exerte', 'expende', 'extend', 'expecte', 'extended']
hierarchal:	hierachial -> ['m', 'mercia', 'preachin', 'teaching', 'impartial']
really:	realy -> ['realm', 'ready', 'real', 'rely', 'reply']	relley -> ['felled', 'belly', 'elle', 'feller', 'galley']	relly -> ['belly', 'reply', 'rally', 'redl', 'jelly']
voting:	voteing -> ['j', 'nothing', 'rotti', 'jottin', 'noting']
committee:	comittee -> ['comm', 'committed', 'commi', 'comm', 'committee']
wanted:	wantid -> ['wane', 'pante', 'wafte', 'wantin', 'wanted']	wonted -> ['hoote', 'wronge', 'longed', 'noted', 'wanted']
benefits:	benifits -> ['be', 'bef', 'bene', 'benefit', 'befits']
definitions:	defenitions -> ['des', 'del', 'deser', 'desertions', 'deletions']
scissors:	scisors -> ['scisso', 'scion', 'scis', 'sciss', 'scissors']	sissors -> ['mirro', 'sisters', 'sci', 'sc', 'scissors']
levels:	levals -> ['level', 'devils', 'levers', 'rivals', 'revels']
parallel:	paralel -> ['paral', 'paradol', 'paralle', 'parall', 'parallel']	paralell -> ['parallel', 'paralle', 'parall', 'paralle', 'parallel']	parrallel -> ['pa', 'para', 'pa', 'par', 'parallel']	parralell -> ['par', 'parallel', 'paral', 'paralle', 'parallel']	parrallell -> ['pa', 'par', 'parallel', 'par', 'parallel']
accommodation:	accomodation -> ['accomm', 'accommodating', 'accumulation', 'accomm', 'accommodating']	acommodation -> ['acc', 'accommodating', 'commotion', 'acc', 'accommodating']	acomodation -> ['approb', 'avo', 'av', 'avocat', 'abomination']
planned:	planed -> ['plane', 'played', 'planet', 'planted', 'planes']
hierarchy:	hierchy -> ['fiercer', 'hit', 'hitch', 'pit', 'pitchy']
transferred:	transfred -> ['transferr', 'transferre', 'transformed', 'transfus', 'transfused']
minutes:	muinets -> ['m', 'mines', 'miners', 'guinea', 'muskets']
arrangeing:	aranging -> ['cringi', 'ragi', 'ar', 'arr', 'arranging']
accessing:	accesing -> ['atheli', 'accepti', 'accept', 'accept', 'accepting']
stomach:	stomac -> ['stocks', 'static', 'stomachs', 'stomach', 'stomach']	stomache -> ['stomach', 'stomachs', 'stomachs', 'stomach', 'stomachs']	stomec -> ['stoner', 'stones', 'stored', 'storey', 'stores']	stumache -> ['sto', 'sto', 'sto', 'stomach', 'stomachs']
unfortunately:	unfortunatly -> ['unfortunate', 'unfortunate', 'unfortunatel', 'unfortunate', 'unfortunately']
considerable:	conciderable -> ['cons', 'considerably', 'cons', 'cons', 'considerable']
access:	acess -> ['acce', 'ac', 'chess', 'acc', 'access']
singular:	singulaur -> ['singular', 'singula', 'singular', 'singula', 'singular']
scarcely:	scarcly -> ['scarce', 'scarce', 'sharpl', 'smartl', 'scarcely']	scarecly -> ['scarc', 'scarce', 'scarce', 'scarce', 'scarcely']	scarely -> ['scare', 'scaly', 'stately', 'sanel', 'scarcely']	scarsely -> ['scarc', 'co', 'coars', 'hoars', 'scarcely']
questionnaire:	questionaire -> ['questionab', 'questionab', 'questioning', 'questionabl', 'questionable']
experience:	experance -> ['exu', 'experie', 'experience', 'exub', 'exuberance']	experiance -> ['experienced', 'experiences', 'experie', 'experie', 'experience']
possible:	possable -> ['possi', 'pa', 'pa', 'possible', 'passable']
refreshment:	reafreshment -> ['re', 'refreshments', 'ref', 're', 'refreshment']	refreshmant -> ['r', 'refreshments', 'refreshme', 'refreshme', 'refreshment']	refresment -> ['refreshm', 'refreshments', 'represent', 'refresh', 'refreshment']	refressmunt -> ['refresh', 'refresh', 'refreshme', 'refreshme', 'refreshment']
embarrass:	embaras -> ['embar', 'embarr', 'embarrass', 'embarr', 'embarrass']	embarass -> ['emb', 'embarra', 'embar', 'embarr', 'embarrass']
visitors:	vistors -> ['victory', 'history', 'visit', 'visi', 'visitors']
auxiliary:	auxillary -> ['audit', 'audito', 'auditory', 'pillar', 'artillery']
decided:	descided -> ['resided', 'de', 'dec', 'decide', 'decided']
benefit:	benifit -> ['u', 'unfit', 'bene', 'bene', 'benefit']
consider:	concider -> ['concise', 'considers', 'cons', 'confide', 'consider']
fails:	failes -> ['f', 'fails', 'files', 'failed', 'fables']
career:	carrer -> ['carv', 'carter', 'carver', 'carrier', 'career']
occurrence:	occurence -> ['occurrences', 'occurre', 'occur', 'occurr', 'occurrence']	occurence -> ['occurrences', 'occurre', 'occur', 'occurr', 'occurrence']
certain:	cirtain -> ['cu', 'captain', 'contain', 'certain', 'curtain']
poem:	poame -> ['pale', 'page', 'pok', 'poke', 'pomp']
lieu:	liew -> ['like', 'lies', 'view', 'lie', 'lieu']
establishing:	astablishing -> ['astonishing', 'establishin', 'e', 'e', 'establishing']	establising -> ['establish', 'establish', 'establishi', 'establish', 'establishing']
different:	diffrent -> ['d', 'differ', 'diff', 'diffe', 'different']
loans:	lones -> ['ones', 'lines', 'loves', 'hones', 'lanes']
extremely:	extreamly -> ['extrem', 'extrem', 'extrem', 'extreme', 'extremely']
addressable:	addresable -> ['adv', 'ad', 'advisa', 'ag', 'agreeable']
gallery:	galery -> ['galley', 'galle', 'gal', 'gall', 'gallery']	gallary -> ['galle', 'galley', 'galle', 'galle', 'gallery']	gallerry -> ['gallery', 'galley', 'galle', 'galler', 'gallery']	gallrey -> ['galler', 'gallery', 'valley', 'alley', 'galley']
centrally:	centraly -> ['central', 'co', 'contrary', 'central', 'central']
families:	familes -> ['s', 'smiles', 'family', 'famili', 'families']
bicycle:	bicycal -> ['bicyc', 'bicycl', 'bicycl', 'bicycle', 'bicycle']	bycicle -> ['vehicl', 'buck', 'buckle', 'article', 'bicycle']	bycycle -> ['bicycles', 'cycle', 'bi', 'bi', 'bicycle']
choice:	choise -> ['cho', 'choose', 'chaise', 'chose', 'choice']
opposite:	opisite -> ['oppo', 'opp', 'opposite', 'opia', 'opiate']	oppasite -> ['o', 'opp', 'oppo', 'oppo', 'opposite']	oppesite -> ['a', 'oppo', 'appetite', 'oppo', 'opposite']	oppisit -> ['oppose', 'oppose', 'deposit', 'opposite', 'opposite']	oppisite -> ['o', 'opp', 'oppo', 'oppo', 'opposite']	opposit -> ['deposit', 'oppose', 'opposed', 'opposite', 'opposite']	oppossite -> ['op', 'opposi', 'oppo', 'oppos', 'opposite']	oppossitte -> ['oppo', 'oppos', 'opposit', 'oppos', 'opposite']
curtains:	cartains -> ['cap', 'cu', 'cu', 'curtains', 'captains']	certans -> ['certain', 'certain', 'curtains', 'germans', 'certing']	courtens -> ['courtesy', 'courteous', 'courts', 'courted', 'courted']	cuaritains -> ['cur', 'curtain', 'cur', 'cu', 'curtains']	curtans -> ['curtai', 'curtain', 'currants', 'curtain', 'curtains']	curtians -> ['m', 'curtai', 'curtai', 'curtains', 'martians']	curtions -> ['curious', 'curtai', 'curtains', 'cushi', 'portions']
address:	adress -> ['caress', 'agrees', 'add', 'address', 'dress']	adres -> ['andrew', 'agrees', 'aren', 'andres', 'acres']
liaison:	liaision -> ['mans', 'div', 'd', 'd', 'division']	liason -> ['reason', 'season', 'lesson', 'lion', 'wilson']
management:	managment -> ['manageme', 'manageme', 'managem', 'manage', 'management']
inconvenient:	inconvienient -> ['inconvenien', 'inconvenient', 'inconve', 'inconv', 'inconvenient']	inconvient -> ['inconve', 'inconven', 'inconveni', 'inconven', 'inconvenient']	inconvinient -> ['inconvenien', 'inconvenient', 'inconve', 'inconve', 'inconvenient']
variant:	vairiant -> ['vagr', 'vag', 'val', 'valiant', 'vagrant']
supersede:	supercede -> ['supers', 'superseded', 'supers', 'supers', 'supersede']	superceed -> ['superse', 'supersed', 'supers', 'supers', 'superseded']
200 correct out of 270, 74.07407407407408%
